xxxxxxxxxxxxxxx
xA............x
x.............x
x.............x
x.............x
x.............x
x.............x
x.............x
x.............x
x.............x
x.............x
x.............x
x............Bx
xxxxxxxxxxxxxxx